╔═══════════════════════════════════════════════════════════════════════════╦══════════════════════╗
║                                                                           ║ Data:                ║
╠═══════════════════════════════════════════════════════════════════════════╩══════════════════════╣
║                                                                                                  ║
║                                                                                                  ║
║                                                                                                  ║
║                                                                                                  ║
║        ┌────────────────────┐        ┌────────────────────┐        ┌────────────────────┐        ║
║        │ 1 - DEPÓSITO       │        │ 2 - SAQUE          │        │ 3 - TRANSFERENCIA  │        ║
║        └────────────────────┘        └────────────────────┘        └────────────────────┘        ║
║                                                                                                  ║
║                                                                                                  ║
║                                                                                                  ║
║                                                                                                  ║
║        ┌────────────────────┐        ┌────────────────────┐        ┌────────────────────┐        ║
║        │ 4 - PIX            │        │ 5 - DOC            │        │ 6 - PAGAMENTOS     │        ║
║        └────────────────────┘        └────────────────────┘        └────────────────────┘        ║
║                                                                                                  ║
║                                                                                                  ║
║                                                                                                  ║
║                                                                                                  ║
║        ┌────────────────────┐        ┌────────────────────┐        ┌────────────────────┐        ║
║        │ 7 - SALDO EM TELA  │        │ 8 - SALDO IMPRESSO │        │ 9 - EXTRATOS       │        ║
║        └────────────────────┘        └────────────────────┘        └────────────────────┘        ║
║                                                                                                  ║
║                                                                                                  ║
║                                                                                                  ║
║                                                                                                  ║
╠══════════════════════════════════════════════════════════════════════════════════════════════════╣
║ ESCOLHA A OPERAÇÃO DESEJADA                                                                      ║
╚══════════════════════════════════════════════════════════════════════════════════════════════════╝