╔═══════════════════════════════════════════════════════════════════════════╦══════════════════════╗
║                                                                           ║ Data:                ║
╠═══════════════════════════════════════════════════════════════════════════╩══════════════════════╣
║                                     CADASTRO DE CORRENTISTAS                                     ║
╠══════════════════════════════════════════════════════════════════════════════════════════════════╣
║                                                                                                  ║
║ CPF ...: [              ]                                            Data Cadastro: [          ] ║
║ Nome ..: [                                                 ] Data Nasc: [          ] Idade [   ] ║
║ Ender..: [                                                               ] Número : [          ] ║
║ Compl..: [                           ] Bairro: [                                               ] ║
║ Cidade : [                                                          ] UF: [  ] CEP: [          ] ║
║ Fone ..: [             ]                        Status: (   ) ATIVO (   ) RESTRITO (   ) INATIVO ║
║                                                                                                  ║
║                                                                                                  ║
║                                                                                                  ║
║                                                                                                  ║
║                                                                                                  ║
║                                                                                                  ║
║                                                                                                  ║
║                                                                                                  ║
║                                                                                                  ║
║                                                                                                  ║
║                                                                                                  ║
║                                                                                                  ║
║                                                                                                  ║
║                                                                                                  ║
║                                                                                                  ║
║                                                                                                  ║
╠══════════════════════════════════════════════════════════════════════════════════════════════════╣
║       (N)OVO      (A)LTERAR      (E)XCLUIR      (C)ONSULTAR      (L)ISTAR      (R)ETORNAR        ║
╚══════════════════════════════════════════════════════════════════════════════════════════════════╝